Codi INE,Municipi,Comarca,Domèstic Xarxa 2023,Activitats Econòmiques 2023,Total 2023
25001,ABELLA DE LA CONCA,"PALLARS JUSSÀ, EL        ",7020,44571,51591
08001,ABRERA,"BAIX LLOBREGAT, EL       ",544827,470060,1014887
25002,AGER,"NOGUERA, LA              ",25586,66657,92243
25003,AGRAMUNT,"URGELL, L'               ",211179,172692,383871
08002,AGUILAR DE SEGARRA,"BAGES, EL                ",12192,256,12448
17001,AGULLANA,"ALT EMPORDÀ, L'          ",33507,4090,37597
08014,AIGUAFREDA,"VALLÈS ORIENTAL, EL      ",100212,22878,123090
43001,AIGUAMURCIA,"ALT CAMP, L'             ",52609,61618,114227
17002,AIGUAVIVA,"GIRONÈS, EL     ",23108,152214,175322
25038,AITONA,"SEGRIÀ, EL               ",91479,34819,126298
25004,"ALAMUS, ELS","SEGRIÀ, EL               ",29230,8846,38076
25005,ALAS I CERC,"ALT URGELL, L'           ",23265,5943,29208
25006,"ALBAGES, L'","GARRIGUES, LES           ",13029,15713,28742
17003,ALBANYA,"ALT EMPORDÀ, L'          ",3343,14806,18149
25007,ALBATARREC,"SEGRIÀ, EL               ",80843,43632,124475
25008,ALBESA,"NOGUERA, LA              ",63078,25142,88220
25009,"ALBI, L'","GARRIGUES, LES           ",22329,2445,24774
43002,ALBINYANA,"BAIX PENEDÈS, EL         ",132810,49599,182409
43003,"ALBIOL, L'","BAIX CAMP, EL            ",18793,263,19056
17004,ALBONS,"BAIX EMPORDÀ, EL         ",50196,21507,71703
43004,ALCANAR,"MONTSIÀ, EL              ",451225,472913,924138
25010,ALCANO,"SEGRIÀ, EL               ",9765,493,10258
25011,ALCARRAS,"SEGRIÀ, EL               ",494185,93082,587267
25012,ALCOLETGE,"SEGRIÀ, EL               ",96736,76228,172964
43005,ALCOVER,"ALT CAMP, L'             ",172150,378468,550618
43904,"ALDEA, L'","BAIX EBRE, EL            ",122088,167723,289811
43006,ALDOVER,"BAIX EBRE, EL            ",42990,1512,44502
43007,"ALEIXAR, L'","BAIX CAMP, EL            ",30819,858,31677
08003,ALELLA,"MARESME, EL              ",533227,121453,654680
43008,ALFARA DE CARLES,"BAIX EBRE, EL            ",21438,1153,22591
25013,ALFARRAS,"SEGRIÀ, EL               ",111607,23043,134650
25014,ALFES,"SEGRIÀ, EL               ",9817,39305,49122
43009,ALFORJA,"BAIX CAMP, EL            ",67284,11757,79041
25015,ALGERRI,"NOGUERA, LA              ",12295,6687,18982
25016,ALGUAIRE,"SEGRIÀ, EL               ",116398,306988,423386
25017,ALINS,"PALLARS SOBIRÀ, EL       ",46134,17309,63443
43010,ALIO,"ALT CAMP, L'             ",14061,13873,27934
25019,ALMACELLES,"SEGRIÀ, EL               ",271258,175933,447191
25020,ALMATRET,"SEGRIÀ, EL               ",11507,70517,82024
25021,ALMENAR,"SEGRIÀ, EL               ",119444,24158,143602
43011,ALMOSTER,"BAIX CAMP, EL            ",88484,1445,89929
25022,ALOS DE BALAGUER,"NOGUERA, LA              ",18846,540,19386
17006,ALP,"CERDANYA, LA             ",145472,654232,799704
08004,ALPENS,"LLUÇANÈS, EL",11211,4346,15557
25023,ALPICAT,"SEGRIÀ, EL               ",287223,265112,552335
25024,ALT ANEU,"PALLARS SOBIRÀ, EL       ",77760,6330,84090
43012,ALTAFULLA,"TARRAGONÈS, EL           ",380036,106567,486603
17007,AMER,"SELVA, LA                ",79095,176493,255588
43013,"AMETLLA DE MAR, L'","BAIX EBRE, EL            ",650443,227441,877884
08005,"AMETLLA DEL VALLES, L'","VALLÈS ORIENTAL, EL      ",432785,110573,543358
43906,"AMPOLLA, L'","BAIX EBRE, EL            ",267267,132089,399356
43014,AMPOSTA,"MONTSIÀ, EL              ",823385,848396,1671781
17008,ANGLES,"SELVA, LA                ",205946,323100,529046
25027,ANGLESOLA,"URGELL, L'               ",52364,38365,90729
25029,ARBECA,"GARRIGUES, LES           ",67830,108638,176468
43016,"ARBOÇ, L'","BAIX PENEDÈS, EL         ",195138,220076,415214
43015,ARBOLI,"BAIX CAMP, EL            ",3871,674,4545
17009,ARBUCIES,"SELVA, LA                ",247599,914119,1161718
08006,ARENYS DE MAR,"MARESME, EL              ",677628,255379,933007
08007,ARENYS DE MUNT,"MARESME, EL              ",460371,142383,602754
17010,ARGELAGUER,"GARROTXA, LA             ",16846,101689,118535
08008,ARGENÇOLA,"ANOIA, L'                ",6033,134,6167
43017,"ARGENTERA, L'","BAIX CAMP, EL            ",6883,892,7775
08009,ARGENTONA,"MARESME, EL              ",547503,244827,792330
17011,"ARMENTERA, L'","ALT EMPORDÀ, L'          ",27707,31757,59464
43018,ARNES,TERRA ALTA               ,21440,28356,49796
25031,ARRES,"VAL D'ARAN, LA           ",2600,144,2744
25032,ARSEGUEL,"ALT URGELL, L'           ",5670,1468,7138
08010,ARTES,"BAGES, EL                ",201262,225149,426411
25033,ARTESA DE LLEIDA,"SEGRIÀ, EL               ",68173,25009,93182
25034,ARTESA DE SEGRE,"NOGUERA, LA              ",129759,162250,292009
43019,ASCO,"RIBERA D'EBRE, LA        ",97092,83644,180736
25036,ASPA,"SEGRIÀ, EL               ",7168,21254,28422
25037,"AVELLANES I SANTA LINYA, LES","NOGUERA, LA              ",22267.2,109676,131943.2
08011,AVIA,"BERGUEDÀ, EL             ",72450,83125,155575
08012,AVINYO,"BAGES, EL                ",72984,304365,377349
17012,AVINYONET DE PUIGVENTOS,"ALT EMPORDÀ, L'          ",67733,15743,83476
08013,AVINYONET DEL PENEDES,"ALT PENEDÈS, L'          ",68742,90130,158872
08015,BADALONA,"BARCELONÈS, EL           ",8110177,1905752,10015929
08904,BADIA DEL VALLES,"VALLÈS OCCIDENTAL, EL    ",397111,83923,481034
08016,BAGA,"BERGUEDÀ, EL             ",70954,20986,91940
25039,BAIX PALLARS,"PALLARS SOBIRÀ, EL       ",40293,3990,44283
25040,BALAGUER,"NOGUERA, LA              ",728094,327872,1055966
08017,BALENYA,OSONA                    ,129448,62656,192104
08018,BALSARENY,"BAGES, EL                ",112710,143711,256421
43020,BANYERES DEL PENEDES,"BAIX PENEDÈS, EL         ",143810,76381,220191
17015,BANYOLES,"PLA DE L'ESTANY, EL      ",891278,869345,1760623
25041,BARBENS,"PLA D'URGELL, EL         ",30951,9430,40381
43021,BARBERA DE LA CONCA,"CONCA DE BARBERÀ, LA     ",23260,27883,51143
08252,BARBERA DEL VALLES,"VALLÈS OCCIDENTAL, EL    ",1259115,943634,2202749
08019,BARCELONA,"BARCELONÈS, EL           ",63401101,33501582,96902683
25042,BARONIA DE RIALB,"NOGUERA, LA              ",4750,50825,55575
17016,BASCARA,"ALT EMPORDÀ, L'          ",38869,10508,49377
25044,BASSELLA,"ALT URGELL, L'           ",6611,94315,100926
43022,BATEA,TERRA ALTA               ,51852,32366,84218
25045,BAUSEN,"VAL D'ARAN, LA           ",6660,432,7092
08020,BEGUES,"BAIX LLOBREGAT, EL       ",334775,55121,389896
17013,BEGUR,"BAIX EMPORDÀ, EL         ",691807,292355,984162
25046,BELIANES,"URGELL, L'               ",19675,58176,77851
25170,BELLAGUARDA,"GARRIGUES, LES           ",7522,1922,9444
17018,BELLCAIRE D'EMPORDA,"BAIX EMPORDÀ, EL         ",59677,14692,74369
25047,BELLCAIRE D'URGELL,"NOGUERA, LA              ",58627,15740,74367
25048,BELL-LLOC D'URGELL,"PLA D'URGELL, EL         ",99996,502542,602538
43023,BELLMUNT DE PRIORAT,"PRIORAT, EL              ",23616,3660,27276
25049,BELLMUNT D'URGELL,"NOGUERA, LA              ",9913,7486,17399
08021,BELLPRAT,"ANOIA, L'                ",1255,0,1255
25050,BELLPUIG,"URGELL, L'               ",198844,194004,392848
43024,BELLVEI,"BAIX PENEDÈS, EL         ",120354,41578,161932
25051,BELLVER DE CERDANYA,"CERDANYA, LA             ",147472,98934,246406
25052,BELLVIS,"PLA D'URGELL, EL         ",71435,18839,90274
25053,BENAVENT DE SEGRIA,"SEGRIÀ, EL               ",70712,25609,96321
43025,BENIFALLET,"BAIX EBRE, EL            ",18696,2240,20936
43026,BENISSANET,"RIBERA D'EBRE, LA        ",35112,7819,42931
08022,BERGA,"BERGUEDÀ, EL             ",554493,270102,824595
17019,BESALU,"GARROTXA, LA             ",94296,47835,142131
17020,BESCANO,"GIRONÈS, EL     ",156878,71745,228623
17021,BEUDA,"GARROTXA, LA             ",6419,58424,64843
08023,BIGUES I RIELLS,"VALLÈS ORIENTAL, EL      ",455217,69894,525111
25055,BIOSCA,"SEGARRA, LA              ",7312,5336,12648
43027,"BISBAL DE FALSET, LA","PRIORAT, EL              ",8244,1181,9425
43028,"BISBAL DEL PENEDES, LA","BAIX PENEDÈS, EL         ",242141,102796,344937
17022,"BISBAL D'EMPORDA, LA","BAIX EMPORDÀ, EL         ",400189,131304,531493
17234,BIURE,"ALT EMPORDÀ, L'          ",12538,300,12838
43029,BLANCAFORT,"CONCA DE BARBERÀ, LA     ",12586,5827,18413
17023,BLANES,"SELVA, LA                ",1822754,969220,2791974
17029,BOADELLA I LES ESCAULES,"ALT EMPORDÀ, L'          ",8010,3473,11483
17024,BOLVIR,"CERDANYA, LA             ",38965,459310,498275
43030,BONASTRE,"BAIX PENEDÈS, EL         ",41211,627,41838
25057,"BORDES, ES","VAL D'ARAN, LA           ",26235,516,26751
17025,BORDILS,"GIRONÈS, EL     ",78564,36571,115135
25058,"BORGES BLANQUES, LES","GARRIGUES, LES           ",221726,440332,662058
43031,"BORGES DEL CAMP, LES","BAIX CAMP, EL            ",69720,26274,95994
17026,BORRASSA,"ALT EMPORDÀ, L'          ",25516,541,26057
08024,BORREDA,"BERGUEDÀ, EL             ",15086,21371,36457
25059,BOSSOST,"VAL D'ARAN, LA           ",74784,9081,83865
43032,BOT,TERRA ALTA               ,18580,16662,35242
43033,BOTARELL,"BAIX CAMP, EL            ",53062,22767,75829
25056,BOVERA,"GARRIGUES, LES           ",10074,4364,14438
43034,BRAFIM,"ALT CAMP, L'             ",33001,12968,45969
17027,BREDA,"SELVA, LA                ",155415,15825,171240
08025,"BRUC, EL","ANOIA, L'                ",93455,19310,112765
08026,"BRULL, EL",OSONA                    ,10636,105187,115823
17028,BRUNYOLA,"SELVA, LA                ",4364,11566,15930
43035,CABACES,"PRIORAT, EL              ",10180,3557,13737
25060,CABANABONA,"NOGUERA, LA              ",6774,74421,81195
17031,CABANELLES,"ALT EMPORDÀ, L'          ",12649,4145,16794
17030,CABANES,"ALT EMPORDÀ, L'          ",21962,6794,28756
08027,"CABANYES, LES","ALT PENEDÈS, L'          ",34265,12950,47215
25061,CABO,"ALT URGELL, L'           ",5104,432,5536
43036,CABRA DEL CAMP,"ALT CAMP, L'             ",72210,4837,77047
08028,CABRERA D'ANOIA,"ANOIA, L'                ",59293,5889,65182
08029,CABRERA DE MAR,"MARESME, EL              ",301869,300399,602268
08030,CABRILS,"MARESME, EL              ",619856,80140,699996
17032,CADAQUES,"ALT EMPORDÀ, L'          ",283706,122183,405889
08031,CALAF,"ANOIA, L'                ",110820,39387,150207
43037,CALAFELL,"BAIX PENEDÈS, EL         ",1911838,435731,2347569
08034,CALDERS,Moianès,50168,34763,84931
17033,CALDES DE MALAVELLA,"SELVA, LA                ",422087,822157,1244244
08033,CALDES DE MONTBUI,"VALLÈS ORIENTAL, EL      ",638075,310096,948171
08032,CALDES D'ESTRAC,"MARESME, EL              ",196133,22915,219048
08035,CALELLA,"MARESME, EL              ",847968,648659,1496627
08037,CALLDETENES,OSONA                    ,88678,30661,119339
08038,CALLUS,"BAGES, EL                ",76880,24348,101228
17034,CALONGE,"BAIX EMPORDÀ, EL         ",1058094,310847,1368941
08036,CALONGE DE SEGARRA,"ANOIA, L'                ",7626,34227,41853
25062,CAMARASA,"NOGUERA, LA              ",71327,25642,96969
43903,CAMARLES,"BAIX EBRE, EL            ",118003,52394,170397
43038,CAMBRILS,"BAIX CAMP, EL            ",2440962,1050341,3491303
17035,CAMOS,"PLA DE L'ESTANY, EL      ",22823,15349,38172
17036,CAMPDEVANOL,"RIPOLLÈS, EL             ",121463,44053,165516
17037,CAMPELLES,"RIPOLLÈS, EL             ",10030,6422,16452
08039,CAMPINS,"VALLÈS ORIENTAL, EL      ",31626,6641,38267
17038,CAMPLLONG,"GIRONÈS, EL     ",15687,185770,201457
17039,CAMPRODON,"RIPOLLÈS, EL             ",124408,55349,179757
25063,CANEJAN,"VAL D'ARAN, LA           ",5400,216,5616
17040,CANET D'ADRI,"GIRONÈS, EL     ",29237,6016,35253
08040,CANET DE MAR,"MARESME, EL              ",616259,141263,757522
43907,"CANONJA, LA","TARRAGONÈS, EL           ",200106,6779373,6979479
08041,CANOVELLES,"VALLÈS ORIENTAL, EL      ",632950,243353,876303
08042,CANOVES I SAMALUS,"VALLÈS ORIENTAL, EL      ",137635,11309,148944
17041,CANTALLOPS,"ALT EMPORDÀ, L'          ",17577,5988,23565
08043,CANYELLES,"GARRAF, EL               ",215864,40668,256532
43039,CAPAFONTS,"BAIX CAMP, EL            ",4648,1646,6294
43040,CAPÇANES,"PRIORAT, EL              ",15473,3440,18913
08044,CAPELLADES,"ANOIA, L'                ",188768,434297,623065
17042,CAPMANY,"ALT EMPORDÀ, L'          ",25657,12268,37925
08045,CAPOLAT,"BERGUEDÀ, EL             ",1322,6064,7386
08046,CARDEDEU,"VALLÈS ORIENTAL, EL      ",695305,161506,856811
08047,CARDONA,"BAGES, EL                ",150159,294059,444218
08048,CARME,"ANOIA, L'                ",26321,1035,27356
43041,CASERES,TERRA ALTA               ,10311,10272,20583
17044,CASSA DE LA SELVA,"GIRONÈS, EL     ",389218,157466,546684
08049,CASSERRES,"BERGUEDÀ, EL             ",52078,68872,120950
08057,CASTELL DE L'ARENY,"BERGUEDÀ, EL             ",3344,394,3738
25904,CASTELL DE MUR,"PALLARS JUSSÀ, EL        ",6787.5,18717,25504.5
25064,CASTELLAR DE LA RIBERA,"SOLSONÈS, EL             ",4917,172935,177852
08052,CASTELLAR DE N'HUG,"BERGUEDÀ, EL             ",11340,3875,15215
08050,CASTELLAR DEL RIU,"BERGUEDÀ, EL             ",5243,13707,18950
08051,CASTELLAR DEL VALLES,"VALLÈS OCCIDENTAL, EL    ",1024417,354058,1378475
08053,CASTELLBELL I EL VILAR,"BAGES, EL                ",148360,46866,195226
08054,CASTELLBISBAL,"VALLÈS OCCIDENTAL, EL    ",527898,3853877,4381775
08055,CASTELLCIR,Moianès,29293,55710,85003
25067,CASTELLDANS,"GARRIGUES, LES           ",31299,2275,33574
08056,CASTELLDEFELS,"BAIX LLOBREGAT, EL       ",2896382,724801,3621183
08058,CASTELLET I LA GORNAL,"ALT PENEDÈS, L'          ",142146,63038,205184
17046,CASTELLFOLLIT DE LA ROCA,"GARROTXA, LA             ",38430,8538,46968
08060,CASTELLFOLLIT DE RIUBREGOS,"ANOIA, L'                ",7232,10706,17938
08059,CASTELLFOLLIT DEL BOIX,"BAGES, EL                ",20930,11361,32291
08061,CASTELLGALÍ,"BAGES, EL                ",93846,192006,285852
08062,CASTELLNOU DE BAGES,"BAGES, EL                ",67296,32014,99310
25068,CASTELLNOU DE SEANA,"PLA D'URGELL, EL         ",48708,4424,53132
25069,CASTELLO DE FARFANYA,"NOGUERA, LA              ",21900,40793,62693
17047,CASTELLO D'EMPURIES,"ALT EMPORDÀ, L'          ",1002040,477906,1479946
08063,CASTELLOLI,"ANOIA, L'                ",20097,12296,32393
17048,CASTELL-PLATJA D'ARO I S'AGARÓ,"BAIX EMPORDÀ, EL         ",1424682,951696,2376378
25070,CASTELLSERA,"URGELL, L'               ",43961,5159,49120
08064,CASTELLTERÇOL,Moianès,109532,113997,223529
43042,CASTELLVELL DEL CAMP,"BAIX CAMP, EL            ",140054,19106,159160
08065,CASTELLVI DE LA MARCA,"ALT PENEDÈS, L'          ",62454,25675,88129
08066,CASTELLVI DE ROSANES,"BAIX LLOBREGAT, EL       ",93357,64819,158176
43043,"CATLLAR, EL","TARRAGONÈS, EL           ",291624,133873,425497
25071,CAVA,"ALT URGELL, L'           ",7380,504,7884
17189,"CELLERA DE TER, LA","SELVA, LA                ",63728,33936,97664
17049,CELRA,"GIRONÈS, EL     ",207553,702675,910228
08067,CENTELLES,OSONA                    ,282341,211528,493869
08268,CERCS,"BERGUEDÀ, EL             ",45323,19798,65121
08266,CERDANYOLA DEL VALLES,"VALLÈS OCCIDENTAL, EL    ",2187003,1262699,3449702
08068,CERVELLO,"BAIX LLOBREGAT, EL       ",441436,74964,516400
25072,CERVERA,"SEGARRA, LA              ",334305,181167,515472
25073,CERVIA DE LES GARRIGUES,"GARRIGUES, LES           ",24590,1038,25628
17050,CERVIA DE TER,"GIRONÈS, EL     ",41307,410505,451812
17051,CISTELLA,"ALT EMPORDÀ, L'          ",11616,33071,44687
25074,CIUTADILLA,"URGELL, L'               ",7441,8427,15868
25075,CLARIANA DE CARDENER,"SOLSONÈS, EL             ",2794,22476,25270
25076,"COGUL, EL","GARRIGUES, LES           ",5240,3591.333333333333,8831.333333333332
17054,COLERA,"ALT EMPORDÀ, L'          ",44553,11051,55604
25077,COLL DE NARGO,"ALT URGELL, L'           ",26732,5038,31770
08069,COLLBATO,"BAIX LLOBREGAT, EL       ",247426,31090,278516
43045,COLLDEJOU,"BAIX CAMP, EL            ",4020,288,4308
08070,COLLSUSPINA,Moianès,15898,36997,52895
17055,COLOMERS,"BAIX EMPORDÀ, EL         ",12109,2671,14780
25163,"COMA I LA PEDRA, LA","SOLSONÈS, EL             ",16359,64168,80527
25161,CONCA DE DALT,"PALLARS JUSSÀ, EL        ",47736,1096,48832
43046,CONESA,"CONCA DE BARBERÀ, LA     ",5182,5,5187
43047,CONSTANTI,"TARRAGONÈS, EL           ",192974,308004,500978
08071,COPONS,"ANOIA, L'                ",12498,6076,18574
08072,CORBERA DE LLOBREGAT,"BAIX LLOBREGAT, EL       ",692862,84304,777166
43048,CORBERA D'EBRE,TERRA ALTA               ,33287,4549,37836
25078,CORBINS,"SEGRIÀ, EL               ",59632,33357,92989
17057,CORÇA,"BAIX EMPORDÀ, EL         ",60864,103376,164240
08073,CORNELLA DE LLOBREGAT,"BAIX LLOBREGAT, EL       ",3112772,1315156,4427928
17056,CORNELLA DEL TERRI,"PLA DE L'ESTANY, EL      ",75825,271221,347046
43049,CORNUDELLA DE MONTSANT,"PRIORAT, EL              ",31877,12522,44399
43050,CREIXELL,"TARRAGONÈS, EL           ",324654,131979,456633
17058,CRESPIA,"PLA DE L'ESTANY, EL      ",7056,5325,12381
17901,CRUILLES-MONELLS-SANT SADURNI DE L'HEURA,"BAIX EMPORDÀ, EL         ",70247,29159,99406
08074,CUBELLES,"GARRAF, EL               ",935317,139617,1074934
25079,CUBELLS,"NOGUERA, LA              ",17223,17163,34386
43051,CUNIT,"BAIX PENEDÈS, EL         ",946533,115260,1061793
17060,DARNIUS,"ALT EMPORDÀ, L'          ",29769,2000,31769
17061,DAS,"CERDANYA, LA             ",21441,68786,90227
43901,DELTEBRE,"BAIX EBRE, EL            ",556553,273260,829813
08075,DOSRIUS,"MARESME, EL              ",280315,149730,430045
43053,DUESAIGÜES,"BAIX CAMP, EL            ",7631,1325,8956
17062,"ESCALA, L'","ALT EMPORDÀ, L'          ",947929,323665,1271594
08076,ESPARREGUERA,"BAIX LLOBREGAT, EL       ",843193,281258,1124451
17063,ESPINELVES,OSONA                    ,10252,67596,77848
25081,"ESPLUGA CALBA, L'","GARRIGUES, LES           ",12604,1346,13950
43054,"ESPLUGA DE FRANCOLI, L'","CONCA DE BARBERÀ, LA     ",124872,61427,186299
08077,ESPLUGUES DE LLOBREGAT,"BAIX LLOBREGAT, EL       ",1743415,732002,2475417
17064,ESPOLLA,"ALT EMPORDÀ, L'          ",17349,3985,21334
17065,ESPONELLA,"PLA DE L'ESTANY, EL      ",26768,21241,48009
25082,ESPOT,"PALLARS SOBIRÀ, EL       ",30456,179583,210039
08078,"ESPUNYOLA, L'","BERGUEDÀ, EL             ",6966,33027,39993
08254,"ESQUIROL, L'",OSONA                    ,97686,418908,516594
25088,ESTAMARIU,"ALT URGELL, L'           ",8325,6938,15263
08079,"ESTANY, L'",Moianès,18471,19849,38320
25085,ESTARAS,"SEGARRA, LA              ",6197,45015,51212
25086,ESTERRI D'ANEU,"PALLARS SOBIRÀ, EL       ",51865,111375,163240
25087,ESTERRI DE CARDOS,"PALLARS SOBIRÀ, EL       ",6072,504,6576
43055,FALSET,"PRIORAT, EL              ",69466,51606,121072
17005,"FAR D'EMPORDA, EL","ALT EMPORDÀ, L'          ",19783,28470,48253
25089,FARRERA,"PALLARS SOBIRÀ, EL       ",10260,0,10260
43056,"FATARELLA, LA",TERRA ALTA               ,27618,6265,33883
43057,"FEBRO, LA","BAIX CAMP, EL            ",4603,314,4917
08134,FIGARO-MONTMANY,"VALLÈS ORIENTAL, EL      ",44977,12736,57713
08080,FIGOLS,"BERGUEDÀ, EL             ",1800,471,2271
25908,FIGOLS I ALINYA,"ALT URGELL, L'           ",26730,904,27634
43058,"FIGUERA, LA","PRIORAT, EL              ",6464,2279,8743
17066,FIGUERES,"ALT EMPORDÀ, L'          ",1719921,589922,2309843
43059,FIGUEROLA DEL CAMP,"ALT CAMP, L'             ",13295,8887,22182
17067,FLAÇA,"GIRONÈS, EL     ",42990,18890,61880
43060,FLIX,"RIBERA D'EBRE, LA        ",206094,588921,795015
25092,"FLORESTA, LA","GARRIGUES, LES           ",5506,431,5937
08082,FOGARS DE LA SELVA,"SELVA, LA                ",87119,218903,306022
08081,FOGARS DE MONTCLUS,"VALLÈS ORIENTAL, EL      ",18343,9281,27624
17068,FOIXA,"BAIX EMPORDÀ, EL         ",33602,10649,44251
08083,FOLGUEROLES,OSONA                    ,80815,51751,132566
25093,FONDARELLA,"PLA D'URGELL, EL         ",29606,50018,79624
08084,FONOLLOSA,"BAGES, EL                ",67861,38258,106119
17069,FONTANALS DE CERDANYA,"CERDANYA, LA             ",70655,329315,399970
17070,FONTANILLES,"BAIX EMPORDÀ, EL         ",15858,5344,21202
17071,FONTCOBERTA,"PLA DE L'ESTANY, EL      ",53302,20149,73451
08085,FONT-RUBI,"ALT PENEDÈS, L'          ",64337,51819,116156
25094,FORADADA,"NOGUERA, LA              ",10662,14604,25266
17902,FORALLAC,"BAIX EMPORDÀ, EL         ",97699,125249,222948
43061,FORES,"CONCA DE BARBERÀ, LA     ",2076,11,2087
17073,FORNELLS DE LA SELVA,"GIRONÈS, EL     ",104613,78101,182714
17074,FORTIA,"ALT EMPORDÀ, L'          ",30949,11052,42001
08086,"FRANQUESES DEL VALLES, LES","VALLÈS ORIENTAL, EL      ",730766,629238,1360004
43062,FREGINALS,"MONTSIÀ, EL              ",12680,4153,16833
25096,"FULIOLA, LA","URGELL, L'               ",53683,27603,81286
25097,FULLEDA,"GARRIGUES, LES           ",10595,280,10875
08090,GAIA,"BAGES, EL                ",6750,41421,48171
43063,"GALERA, LA","MONTSIÀ, EL              ",29992,27269,57261
08087,GALLIFA,"VALLÈS OCCIDENTAL, EL    ",6061,402,6463
43064,GANDESA,TERRA ALTA               ,102416,65210,167626
43065,GARCIA,"RIBERA D'EBRE, LA        ",22183,3745,25928
43066,"GARIDELLS, ELS","ALT CAMP, L'             ",8001,10703,18704
08088,"GARRIGA, LA","VALLÈS ORIENTAL, EL      ",623146,326933,950079
17075,GARRIGAS,"ALT EMPORDÀ, L'          ",21157,33583,54740
17076,GARRIGOLES,"BAIX EMPORDÀ, EL         ",13391,16743,30134
17077,GARRIGUELLA,"ALT EMPORDÀ, L'          ",45791,31924,77715
08089,GAVA,"BAIX LLOBREGAT, EL       ",1893975,720189,2614164
25098,GAVET DE LA CONCA,"PALLARS JUSSÀ, EL        ",9438,793,10231
08091,GELIDA,"ALT PENEDÈS, L'          ",327544,344781,672325
17078,GER,"CERDANYA, LA             ",41791,34475,76266
25912,GIMENELLS I EL PLA DE LA FONT,"SEGRIÀ, EL               ",44084,13142,57226
43067,GINESTAR,"RIBERA D'EBRE, LA        ",28199,1157,29356
17079,GIRONA,"GIRONÈS, EL     ",3906056,2734819,6640875
08092,GIRONELLA,"BERGUEDÀ, EL             ",148837,58137,206974
08093,GISCLARENY,"BERGUEDÀ, EL             ",1379,1238,2617
43068,GODALL,"MONTSIÀ, EL              ",20844,8826,29670
25099,GOLMES,"PLA D'URGELL, EL         ",86835,18519,105354
17080,GOMBREN,"RIPOLLÈS, EL             ",6547,2745,9292
25100,GOSOL,"BERGUEDÀ, EL             ",58734,2256,60990
08094,"GRANADA, LA","ALT PENEDÈS, L'          ",76485,29722,106207
25101,"GRANADELLA, LA","GARRIGUES, LES           ",25315,6778,32093
08095,GRANERA,Moianès,4044,707,4751
25102,"GRANJA D'ESCARP, LA","SEGRIÀ, EL               ",37481,7458,44939
08096,GRANOLLERS,"VALLÈS ORIENTAL, EL      ",2256709,1762874,4019583
25103,GRANYANELLA,"SEGARRA, LA              ",1588,30358,31946
25105,GRANYENA DE LES GARRIGUES,"GARRIGUES, LES           ",5859,1217,7076
25104,GRANYENA DE SEGARRA,"SEGARRA, LA              ",6116,0,6116
43069,GRATALLOPS,"PRIORAT, EL              ",7853,8405,16258
08097,GUALBA,"VALLÈS ORIENTAL, EL      ",91179,108579,199758
17081,GUALTA,"BAIX EMPORDÀ, EL         ",37366,409722,447088
08099,GUARDIOLA DE BERGUEDA,"BERGUEDÀ, EL             ",31625,8011,39636
43070,"GUIAMETS, ELS","PRIORAT, EL              ",8752,4477,13229
17082,GUILS DE CERDANYA,"CERDANYA, LA             ",29339,145761,175100
25109,GUIMERA,"URGELL, L'               ",13103,13299,26402
25903,"GUINGUETA D'ANEU, LA","PALLARS SOBIRÀ, EL       ",46224,11032,57256
25110,GUISSONA,"SEGARRA, LA              ",253031,1614672,1867703
25111,GUIXERS,"SOLSONÈS, EL             ",1984,129979,131963
08100,GURB,OSONA                    ,90404,1482262,1572666
43071,HORTA DE SANT JOAN,TERRA ALTA               ,50002,36267,86269
08101,"HOSPITALET DE LLOBREGAT, L'","BARCELONÈS, EL           ",9338154,2823075,12161229
08162,"HOSTALETS DE PIEROLA, ELS","ANOIA, L'                ",134732,152193,286925
17083,HOSTALRIC,"SELVA, LA                ",176758,574372,751130
08102,IGUALADA,"ANOIA, L'                ",1468781,2607663,4076444
25115,ISONA I CONCA DELLA,"PALLARS JUSSÀ, EL        ",35379,9463,44842
17084,ISOVOL,"CERDANYA, LA             ",39125,22977,62102
25112,IVARS DE NOGUERA,"NOGUERA, LA              ",11722,7993,19715
25113,IVARS D'URGELL,"PLA D'URGELL, EL         ",60010,55219,115229
25114,IVORRA,"SEGARRA, LA              ",3626,50648,54274
17085,JAFRE,"BAIX EMPORDÀ, EL         ",20356,9619,29975
17086,"JONQUERA, LA","ALT EMPORDÀ, L'          ",122583,198586,321169
08103,JORBA,"ANOIA, L'                ",30167,36602,66769
25910,JOSA I TUIXEN,"ALT URGELL, L'           ",23640,3432,27072
17087,JUIA,"GIRONÈS, EL     ",16126,52997,69123
25118,JUNCOSA,"GARRIGUES, LES           ",11575,49466,61041
25119,JUNEDA,"GARRIGUES, LES           ",126310,202373,328683
25121,LES,"VAL D'ARAN, LA           ",49820,9693,59513
25122,LINYOLA,"PLA D'URGELL, EL         ",108652,13968,122620
08104,"LLACUNA, LA","ANOIA, L'                ",48827,14467,63294
17088,LLADO,"ALT EMPORDÀ, L'          ",32132,6005,38137
25123,LLADORRE,"PALLARS SOBIRÀ, EL       ",15444,9677,25121
25124,LLADURS,"SOLSONÈS, EL             ",6578,13671,20249
08105,"LLAGOSTA, LA","VALLÈS ORIENTAL, EL      ",478060,144871,622931
17089,LLAGOSTERA,"GIRONÈS, EL     ",382960,108782,491742
17090,LLAMBILLES,"GIRONÈS, EL     ",25877,8194,34071
17091,LLANARS,"RIPOLLÈS, EL             ",31980,11357,43337
17092,LLANÇA,"ALT EMPORDÀ, L'          ",417936,98568,516504
25125,LLARDECANS,"SEGRIÀ, EL               ",13438,1163,14601
25126,LLAVORSI,"PALLARS SOBIRÀ, EL       ",38115,4943,43058
25120,LLEIDA,"SEGRIÀ, EL               ",6527914,4088530,10616444
17093,LLERS,"ALT EMPORDÀ, L'          ",52061,118857,170918
25127,LLES DE CERDANYA,"CERDANYA, LA             ",39888,9919,49807
08107,LLIÇA D'AMUNT,"VALLÈS ORIENTAL, EL      ",763315,154418,917733
08108,LLIÇA DE VALL,"VALLÈS ORIENTAL, EL      ",285523,237711,523234
25128,LLIMIANA,"PALLARS JUSSÀ, EL        ",5448,293,5741
08106,LLINARS DEL VALLES,"VALLÈS ORIENTAL, EL      ",430997,606524,1037521
17094,LLIVIA,"CERDANYA, LA             ",149277,33352,182629
43072,"LLOAR, EL","PRIORAT, EL              ",4783,2038,6821
25129,LLOBERA,"SOLSONÈS, EL             ",4461,2965,7426
43073,LLORAC,"CONCA DE BARBERÀ, LA     ",6649,4,6653
43074,LLORENÇ DEL PENEDES,"BAIX PENEDÈS, EL         ",103917,73825,177742
17095,LLORET DE MAR,"SELVA, LA                ",2322020,1845427,4167447
17096,"LLOSSES, LES","RIPOLLÈS, EL             ",3341,18257,21598
08109,LLUÇA,"LLUÇANÈS, EL",8657,11702,20359
17102,MAÇANET DE CABRENYS,"ALT EMPORDÀ, L'          ",44536,26412,70948
17103,MAÇANET DE LA SELVA,"SELVA, LA                ",397275,222838,620113
17097,MADREMANYA,"GIRONÈS, EL     ",17954,6022,23976
17098,MAIA DE MONTCAL,"GARROTXA, LA             ",19914,18443,38357
25133,MAIALS,"SEGRIÀ, EL               ",29456,29210,58666
25130,MALDA,"URGELL, L'               ",7843,43736,51579
08110,MALGRAT DE MAR,"MARESME, EL              ",854985,1064897,1919882
08111,MALLA,OSONA                    ,11554,57090,68644
08112,MANLLEU,OSONA                    ,724611,438188,1162799
08113,MANRESA,"BAGES, EL                ",3030203,1017757,4047960
43076,MARÇA,"PRIORAT, EL              ",13592,1191,14783
43075,MARGALEF,"PRIORAT, EL              ",4845,1632,6477
08242,MARGANELL,"BAGES, EL                ",19394,4241,23635
08114,MARTORELL,"BAIX LLOBREGAT, EL       ",1044084,4555957,5600041
08115,MARTORELLES,"VALLÈS ORIENTAL, EL      ",198349,1284837,1483186
43077,MAS DE BARBERANS,"MONTSIÀ, EL              ",15809,1350,17159
17100,MASARAC,"ALT EMPORDÀ, L'          ",20103,45362,65465
43078,MASDENVERGE,"MONTSIÀ, EL              ",35845,53682,89527
08116,"MASIES DE RODA, LES",OSONA                    ,28002,56323,84325
08117,"MASIES DE VOLTREGA, LES",OSONA                    ,126465,447429,573894
43079,MASLLORENÇ,"BAIX PENEDÈS, EL         ",27806,3512,31318
08118,"MASNOU, EL","MARESME, EL              ",1095145,324050,1419195
43080,"MASO, LA","ALT CAMP, L'             ",18042,692,18734
43081,MASPUJOLS,"BAIX CAMP, EL            ",25641,1138,26779
08119,MASQUEFA,"ANOIA, L'                ",380803,85090,465893
43082,"MASROIG, EL","PRIORAT, EL              ",15585,5249,20834
25131,MASSALCOREIG,"SEGRIÀ, EL               ",45246,2508,47754
17101,MASSANES,"SELVA, LA                ",39703,217774,257477
25132,MASSOTERES,"SEGARRA, LA              ",9338,85275,94613
08120,MATADEPERA,"VALLÈS OCCIDENTAL, EL    ",571705,157413,729118
08121,MATARO,"MARESME, EL              ",4519235,1664944,6184179
17904,MEDINYÀ,"GIRONÈS, EL     ",0,0,0
08122,MEDIONA,"ALT PENEDÈS, L'          ",131939,28388,160327
25134,MENARGUENS,"NOGUERA, LA              ",34329,7434,41763
17099,MERANGES,"CERDANYA, LA             ",11210,1368,12578
17105,MIERES,"GARROTXA, LA             ",10087,6117,16204
43083,"MILA, EL","ALT CAMP, L'             ",6164,257,6421
25135,MIRALCAMP,"PLA D'URGELL, EL         ",67284,344638,411922
43084,MIRAVET,"RIBERA D'EBRE, LA        ",20465,2135,22600
08138,MOIA,Moianès,248425,277145,525570
43085,"MOLAR, EL","PRIORAT, EL              ",10628,4360,14988
08123,MOLINS DE REI,"BAIX LLOBREGAT, EL       ",998922,346796,1345718
25137,MOLLERUSSA,"PLA D'URGELL, EL         ",632445,2424906,3057351
17106,MOLLET DE PERALADA,"ALT EMPORDÀ, L'          ",8810,2293,11103
08124,MOLLET DEL VALLES,"VALLÈS ORIENTAL, EL      ",1809118,921712,2730830
17107,MOLLO,"RIPOLLÈS, EL             ",21782,6335,28117
25136,"MOLSOSA, LA","SOLSONÈS, EL             ",2742,253,2995
08128,MONISTROL DE CALDERS,Moianès,32241,17536,49777
08127,MONISTROL DE MONTSERRAT,"BAGES, EL                ",112834,235075,347909
17109,MONTAGUT,"GARROTXA, LA             ",36941,28107,65048
43086,MONTBLANC,"CONCA DE BARBERÀ, LA     ",248972,314725,563697
43088,MONTBRIO DEL CAMP,"BAIX CAMP, EL            ",101875,95938,197813
08125,MONTCADA I REIXAC,"VALLÈS OCCIDENTAL, EL    ",1338162,1100364,2438526
08130,MONTCLAR,"BERGUEDÀ, EL             ",5159,158297,163456
25139,MONTELLA I MARTINET,"CERDANYA, LA             ",31078,15003,46081
08131,MONTESQUIU,OSONA                    ,37367,10647,48014
25140,MONTFERRER I CASTELLBO,"ALT URGELL, L'           ",49350,323315,372665
43089,MONTFERRI,"ALT CAMP, L'             ",27041,5064,32105
25138,MONTGAI,"NOGUERA, LA              ",26915,3590,30505
08126,MONTGAT,"MARESME, EL              ",470991,75462,546453
08132,MONTMAJOR,"BERGUEDÀ, EL             ",22459,137125,159584
08133,MONTMANEU,"ANOIA, L'                ",3830,31932,35762
43090,"MONTMELL, EL","BAIX PENEDÈS, EL         ",124162,10418,134580
08135,MONTMELO,"VALLÈS ORIENTAL, EL      ",320957,739808,1060765
25142,MONTOLIU DE LLEIDA,"SEGRIÀ, EL               ",19927,10416,30343
25141,MONTOLIU DE SEGARRA,"SEGARRA, LA              ",8158,809,8967
25143,MONTORNES DE SEGARRA,"SEGARRA, LA              ",4324,165,4489
08136,MONTORNES DEL VALLES,"VALLÈS ORIENTAL, EL      ",633586,580079,1213665
43091,MONT-RAL,"ALT CAMP, L'             ",8764,298,9062
17110,MONT-RAS,"BAIX EMPORDÀ, EL         ",80944,31249,112193
43092,MONT-ROIG DEL CAMP,"BAIX CAMP, EL            ",1348595,651441,2000036
08137,MONTSENY,"VALLÈS ORIENTAL, EL      ",13158,14056,27214
43093,MORA D'EBRE,"RIBERA D'EBRE, LA        ",211706,774975,986681
43094,MORA LA NOVA,"RIBERA D'EBRE, LA        ",123246,146143,269389
43095,"MORELL, EL","TARRAGONÈS, EL           ",86903,7724679,7811582
43096,"MORERA DE MONTSANT, LA","PRIORAT, EL              ",12510,5736,18246
08129,MUNTANYOLA,OSONA                    ,31218,16050,47268
08139,MURA,"BAGES, EL                ",13768,5245,19013
25145,NALEC,"URGELL, L'               ",3052,1182,4234
25025,NAUT ARAN,"VAL D'ARAN, LA           ",596484,855658,1452142
08140,NAVARCLES,"BAGES, EL                ",219938,117801,337739
08141,NAVAS,"BAGES, EL                ",231838,141805,373643
17111,NAVATA,"ALT EMPORDÀ, L'          ",100322,148999,249321
25146,NAVES,"SOLSONÈS, EL             ",12568,104973,117541
08142,"NOU DE BERGUEDA, LA","BERGUEDÀ, EL             ",5558,2511,8069
43097,"NOU DE GAIA, LA","TARRAGONÈS, EL           ",24251,1,24252
43098,NULLES,"ALT CAMP, L'             ",23894,1429,25323
25148,ODEN,"SOLSONÈS, EL             ",2388,6983,9371
08143,ODENA,"ANOIA, L'                ",126664,126881,253545
17112,OGASSA,"RIPOLLÈS, EL             ",8225,9160,17385
08145,OLERDOLA,"ALT PENEDÈS, L'          ",179036,282852,461888
08146,OLESA DE BONESVALLS,"ALT PENEDÈS, L'          ",108381,21900,130281
08147,OLESA DE MONTSERRAT,"BAIX LLOBREGAT, EL       ",921941,1039286,1961227
25149,OLIANA,"ALT URGELL, L'           ",82607,112292,194899
25150,OLIOLA,"NOGUERA, LA              ",6560,163346,169906
25151,OLIUS,"SOLSONÈS, EL             ",43041,57576,100617
08148,OLIVELLA,"GARRAF, EL               ",254899,21342,276241
08149,OLOST,"LLUÇANÈS, EL",39989,168140,208129
17114,OLOT,"GARROTXA, LA             ",1527052,1623313,3150365
25152,"OLUGES, LES","SEGARRA, LA              ",7705,6436,14141
08144,OLVAN,"BERGUEDÀ, EL             ",24969,20668,45637
25153,"OMELLONS, ELS","GARRIGUES, LES           ",6204,335,6539
25154,"OMELLS DE NA GAIA, ELS","URGELL, L'               ",5465,22817,28282
17115,ORDIS,"ALT EMPORDÀ, L'          ",15183,14054,29237
25155,ORGANYA,"ALT URGELL, L'           ",43112,39984,83096
08150,ORIS,OSONA                    ,9729,103121,112850
08151,ORISTA,"LLUÇANÈS, EL",15078,47781,62859
08152,ORPI,"ANOIA, L'                ",6500,1557,8057
08153,ORRIUS,"MARESME, EL              ",35734,6158,41892
25156,OS DE BALAGUER,"NOGUERA, LA              ",51385,6036,57421
17116,OSOR,"SELVA, LA                ",16630,51759,68389
25157,OSSO DE SIO,"URGELL, L'               ",7208,68036,75244
08154,PACS DEL PENEDES,"ALT PENEDÈS, L'          ",46189,152601,198790
08155,PALAFOLLS,"MARESME, EL              ",379091,630645,1009736
17117,PALAFRUGELL,"BAIX EMPORDÀ, EL         ",1447775,474337,1922112
17118,PALAMOS,"BAIX EMPORDÀ, EL         ",919217,342846,1262063
25158,"PALAU D'ANGLESOLA, EL","PLA D'URGELL, EL         ",93468,84157,177625
17119,PALAU DE SANTA EULALIA,"ALT EMPORDÀ, L'          ",7646,366,8012
17121,PALAU-SATOR,"BAIX EMPORDÀ, EL         ",31485,34008,65493
17120,PALAU-SAVERDERA,"ALT EMPORDÀ, L'          ",97154,25376,122530
08156,PALAU-SOLITÀ I PLEGAMANS,"VALLÈS OCCIDENTAL, EL    ",588129,476587,1064716
43100,"PALLARESOS, ELS","TARRAGONÈS, EL           ",231738,41463,273201
08157,PALLEJA,"BAIX LLOBREGAT, EL       ",475508,106896,582404
08905,"PALMA DE CERVELLO, LA","BAIX LLOBREGAT, EL       ",129921,24370,154291
43099,"PALMA D'EBRE, LA","RIBERA D'EBRE, LA        ",12122,4269,16391
17123,PALOL DE REVARDIT,"PLA DE L'ESTANY, EL      ",14106,55908,70014
17124,PALS,"BAIX EMPORDÀ, EL         ",338714,697448,1036162
08158,"PAPIOL, EL","BAIX LLOBREGAT, EL       ",169475,256560,426035
17125,PARDINES,"RIPOLLÈS, EL             ",7334,2328,9662
08159,PARETS DEL VALLES,"VALLÈS ORIENTAL, EL      ",741871,1672043,2413914
17126,PARLAVA,"BAIX EMPORDÀ, EL         ",32836,35734,68570
43101,PASSANANT I BELLTALL,"CONCA DE BARBERÀ, LA     ",4843,936,5779
17128,PAU,"ALT EMPORDÀ, L'          ",42484,20837,63321
43102,PAÜLS,"BAIX EBRE, EL            ",38772,2268,41040
17129,PEDRET I MARZA,"ALT EMPORDÀ, L'          ",10980,9554,20534
25164,PENELLES,"NOGUERA, LA              ",17208,10501,27709
17130,"PERA, LA","BAIX EMPORDÀ, EL         ",20262,16330,36592
08160,PERAFITA,"LLUÇANÈS, EL",16226,23053,39279
43103,PERAFORT,"TARRAGONÈS, EL           ",48165,9826,57991
17132,PERALADA,"ALT EMPORDÀ, L'          ",132114,283995,416109
25165,PERAMOLA,"ALT URGELL, L'           ",26967,44354,71321
43104,"PERELLO, EL","BAIX EBRE, EL            ",131400,77254,208654
08161,PIERA,"ANOIA, L'                ",750153,83019,833172
43105,"PILES, LES","CONCA DE BARBERÀ, LA     ",7368,2753,10121
08163,PINEDA DE MAR,"MARESME, EL              ",995265,467888,1463153
43106,"PINELL DE BRAI, EL",TERRA ALTA               ,30488,5588,36076
25166,PINELL DE SOLSONES,"SOLSONÈS, EL             ",5397,961,6358
25167,PINOS,"SOLSONÈS, EL             ",9618,629,10247
43107,PIRA,"CONCA DE BARBERÀ, LA     ",17597,11245,28842
43108,"PLA DE SANTA MARIA, EL","ALT CAMP, L'             ",99142,197437,296579
08164,"PLA DEL PENEDES, EL","ALT PENEDÈS, L'          ",49356,10088,59444
17133,"PLANES D'HOSTOLES, LES","GARROTXA, LA             ",61779,80323,142102
17134,PLANOLES,"RIPOLLÈS, EL             ",25646,8115,33761
25911,"PLANS DE SIO, ELS","SEGARRA, LA              ",15546,161965,177511
25168,"POAL, EL","PLA D'URGELL, EL         ",38592,3085,41677
25169,"POBLA DE CERVOLES, LA","GARRIGUES, LES           ",10818,1093,11911
08165,"POBLA DE CLARAMUNT, LA","ANOIA, L'                ",95709,1701738,1797447
08166,"POBLA DE LILLET, LA","BERGUEDÀ, EL             ",37490,20830,58320
43109,"POBLA DE MAFUMET, LA","TARRAGONÈS, EL           ",110013,15222369,15332382
43110,"POBLA DE MASSALUCA, LA",TERRA ALTA               ,13082,11326,24408
43111,"POBLA DE MONTORNES, LA","TARRAGONÈS, EL           ",199217,52697,251914
25171,"POBLA DE SEGUR, LA","PALLARS JUSSÀ, EL        ",279480,12606,292086
43112,POBOLEDA,"PRIORAT, EL              ",14420,1528,15948
08167,POLINYA,"VALLÈS OCCIDENTAL, EL    ",328803,245286,574089
43113,"PONT D'ARMENTERA, EL","ALT CAMP, L'             ",19602,10124,29726
25030,"PONT DE BAR, EL","ALT URGELL, L'           ",11098,3860,14958
17135,PONT DE MOLINS,"ALT EMPORDÀ, L'          ",20921,56872,77793
25173,"PONT DE SUERT, EL","ALTA RIBAGORÇA, L'       ",149150,33095,182245
08182,"PONT DE VILOMARA I ROCAFORT, EL","BAGES, EL                ",172035,63985,236020
43141,PONTILS,"CONCA DE BARBERÀ, LA     ",7479,19768,27247
08168,PONTONS,"ALT PENEDÈS, L'          ",25673,5173,30846
17136,PONTOS,"ALT EMPORDÀ, L'          ",9705,3263,12968
25172,PONTS,"NOGUERA, LA              ",103102,100037,203139
17137,PORQUERES,"PLA DE L'ESTANY, EL      ",190905,72509,263414
43114,PORRERA,"PRIORAT, EL              ",14797,8180,22977
17140,"PORT DE LA SELVA, EL","ALT EMPORDÀ, L'          ",152192,49342,201534
17138,PORTBOU,"ALT EMPORDÀ, L'          ",47626,15738,63364
25174,"PORTELLA, LA","SEGRIÀ, EL               ",30728,22775,53503
43115,PRADELL DE LA TEIXETA,"PRIORAT, EL              ",5259,2270,7529
43116,PRADES,"BAIX CAMP, EL            ",33296,16681,49977
43117,PRAT DE COMTE,TERRA ALTA               ,7966,2692,10658
08169,"PRAT DE LLOBREGAT, EL","BAIX LLOBREGAT, EL       ",2276511,5920078,8196589
43118,PRATDIP,"BAIX CAMP, EL            ",49887,11174,61061
08171,PRATS DE LLUÇANES,"LLUÇANÈS, EL",86134,90428,176562
08170,"PRATS DEL REI, ELS","ANOIA, L'                ",18072,29264,47336
25175,PRATS I SANSOR,"CERDANYA, LA             ",74359,34539,108898
25176,PREIXANA,"URGELL, L'               ",14035,15871,29906
25177,PREIXENS,"NOGUERA, LA              ",15279,11261,26540
08230,PREMIA DE DALT,"MARESME, EL              ",599945,82237,682182
08172,PREMIA DE MAR,"MARESME, EL              ",1188152,199421,1387573
17139,"PRESES, LES","GARROTXA, LA             ",89222,172498,261720
25179,PRULLANS,"CERDANYA, LA             ",25370,20171,45541
17141,PUIGCERDA,"CERDANYA, LA             ",472472,338687,811159
08174,PUIGDALBER,"ALT PENEDÈS, L'          ",25091,3609,28700
25180,PUIGGROS,"GARRIGUES, LES           ",12542,219,12761
43119,PUIGPELAT,"ALT CAMP, L'             ",48521,791682,840203
08175,PUIG-REIG,"BERGUEDÀ, EL             ",136500,99125,235625
25181,PUIGVERD D'AGRAMUNT,"URGELL, L'               ",9467,12697,22164
25182,PUIGVERD DE LLEIDA,"SEGRIÀ, EL               ",53686,31775,85461
08176,PUJALT,"ANOIA, L'                ",6555,36843,43398
08177,"QUAR, LA","BERGUEDÀ, EL             ",828,6744,7572
17142,QUART,"GIRONÈS, EL     ",133840,95732,229572
17043,QUERALBS,"RIPOLLÈS, EL             ",11494,145925,157419
43120,QUEROL,"ALT CAMP, L'             ",72007,717,72724
17143,RABOS,"ALT EMPORDÀ, L'          ",7305,1943,9248
08178,RAJADELL,"BAGES, EL                ",24343,22364,46707
43121,RASQUERA,"RIBERA D'EBRE, LA        ",24432,6841,31273
17144,REGENCOS,"BAIX EMPORDÀ, EL         ",15382,37476,52858
08179,RELLINARS,"VALLÈS OCCIDENTAL, EL    ",47657,3025,50682
43122,RENAU,"TARRAGONÈS, EL           ",5699,1483,7182
43123,REUS,"BAIX CAMP, EL            ",3959633,2623755,6583388
25183,RIALP,"PALLARS SOBIRÀ, EL       ",22075,188349,210424
43124,"RIBA, LA","ALT CAMP, L'             ",26476,374877,401353
43125,RIBA-ROJA D'EBRE,"RIBERA D'EBRE, LA        ",49458,5477,54935
25905,RIBERA D'ONDARA,"SEGARRA, LA              ",18374,18278,36652
25185,RIBERA D'URGELLET,"ALT URGELL, L'           ",36200,52500,88700
17145,RIBES DE FRESER,"RIPOLLÈS, EL             ",77685,134700,212385
17146,RIELLS I VIABREA,"SELVA, LA                ",233496,45948,279444
43126,"RIERA DE GAIA, LA","TARRAGONÈS, EL           ",65953,23312,89265
25186,RINER,"SOLSONÈS, EL             ",6894,4735,11629
17147,RIPOLL,"RIPOLLÈS, EL             ",395105,256807,651912
08180,RIPOLLET,"VALLÈS OCCIDENTAL, EL    ",1411136,376237,1787373
25913,RIU DE CERDANYA,"CERDANYA, LA             ",7524,2883,10407
17148,RIUDARENES,"SELVA, LA                ",102338,124638,226976
17149,RIUDAURA,"GARROTXA, LA             ",21429,2411,23840
43127,RIUDECANYES,"BAIX CAMP, EL            ",55330,4424,59754
43128,RIUDECOLS,"BAIX CAMP, EL            ",40534,16758,57292
17150,RIUDELLOTS DE LA SELVA,"SELVA, LA                ",71860,991078,1062938
43129,RIUDOMS,"BAIX CAMP, EL            ",163442,242093,405535
17151,RIUMORS,"ALT EMPORDÀ, L'          ",9366,1426,10792
08181,"ROCA DEL VALLES, LA","VALLÈS ORIENTAL, EL      ",489216,585951,1075167
43130,ROCAFORT DE QUERALT,"CONCA DE BARBERÀ, LA     ",6447,341,6788
43131,RODA DE BERÀ,"TARRAGONÈS, EL           ",610827,266233,877060
08183,RODA DE TER,OSONA                    ,236916,38966,275882
43132,RODONYA,"ALT CAMP, L'             ",27055,5236,32291
43133,ROQUETES,"BAIX EBRE, EL            ",261451,621806,883257
17152,ROSES,"ALT EMPORDÀ, L'          ",1385392,594537,1979929
25189,ROSSELLO,"SEGRIÀ, EL               ",123140,2117873,2241013
43134,"ROURELL, EL","ALT CAMP, L'             ",14744,1,14745
08184,RUBI,"VALLÈS OCCIDENTAL, EL    ",2920409,1891591,4812000
08185,RUBIO,"ANOIA, L'                ",13361,11611,24972
17153,RUPIA,"BAIX EMPORDÀ, EL         ",25390,7330,32720
08901,RUPIT I PRUIT,OSONA                    ,12012,24902,36914
08187,SABADELL,"VALLÈS OCCIDENTAL, EL    ",7796196,2278524,10074720
08188,SAGAS,"BERGUEDÀ, EL             ",4581,26579,31160
25190,SALAS DE PALLARS,"PALLARS JUSSÀ, EL        ",15790,8802,24592
08190,SALDES,"BERGUEDÀ, EL             ",15208,27875,43083
17154,SALES DE LLIERCA,"GARROTXA, LA             ",6338,808,7146
08191,SALLENT,"BAGES, EL                ",237259,800334,1037593
43135,SALOMO,"TARRAGONÈS, EL           ",27988,13654,41642
43905,SALOU,"TARRAGONÈS, EL           ",2262958,3324531,5587489
17155,SALT,"GIRONÈS, EL     ",911418,274325,1185743
25191,SANAÜJA,"SEGARRA, LA              ",18539,13838,32377
08194,SANT ADRIA DE BESOS,"BARCELONÈS, EL           ",1359760,540689,1900449
08195,SANT AGUSTI DE LLUÇANES,OSONA                    ,6847,27700,34547
08196,SANT ANDREU DE LA BARCA,"BAIX LLOBREGAT, EL       ",1013145,472392,1485537
08197,SANT ANDREU DE LLAVANERES,"MARESME, EL              ",768850,307728,1076578
17157,SANT ANDREU SALOU,"GIRONÈS, EL     ",0,3025,3025
17183,SANT ANIOL DE FINESTRES,"GARROTXA, LA             ",11150,120738,131888
08198,SANT ANTONI DE VILAMAJOR,"VALLÈS ORIENTAL, EL      ",312879,53239,366118
08199,SANT BARTOMEU DEL GRAU,OSONA                    ,29785,39516,69301
08200,SANT BOI DE LLOBREGAT,"BAIX LLOBREGAT, EL       ",2940892,1302485,4243377
08201,SANT BOI DE LLUÇANES,OSONA                    ,18726,50155,68881
43136,SANT CARLES DE LA RAPITA,"MONTSIÀ, EL              ",650600,338780,989380
08203,SANT CEBRIA DE VALLALTA,"MARESME, EL              ",236050,49884,285934
08202,SANT CELONI,"VALLÈS ORIENTAL, EL      ",678866,776496,1455362
08204,SANT CLIMENT DE LLOBREGAT,"BAIX LLOBREGAT, EL       ",142660,23129,165789
17158,SANT CLIMENT SESCEBES,"ALT EMPORDÀ, L'          ",23496,57462,80958
08205,SANT CUGAT DEL VALLES,"VALLÈS OCCIDENTAL, EL    ",4244603,1824924,6069527
08206,SANT CUGAT SESGARRIGUES,"ALT PENEDÈS, L'          ",29090,32823,61913
25196,SANT ESTEVE DE LA SARGA,"PALLARS JUSSÀ, EL        ",11969,492,12461
08207,SANT ESTEVE DE PALAUTORDERA,"VALLÈS ORIENTAL, EL      ",132923,23443,156366
08208,SANT ESTEVE SESROVIRES,"BAIX LLOBREGAT, EL       ",339716,838289,1178005
17159,SANT FELIU DE BUIXALLEU,"SELVA, LA                ",63561,59887,123448
08210,SANT FELIU DE CODINES,"VALLÈS ORIENTAL, EL      ",258088,58971,317059
17160,SANT FELIU DE GUÍXOLS,"BAIX EMPORDÀ, EL         ",1348589,433144,1781733
08211,SANT FELIU DE LLOBREGAT,"BAIX LLOBREGAT, EL       ",1566094,420894,1986988
17161,SANT FELIU DE PALLEROLS,"GARROTXA, LA             ",48963,21933,70896
08212,SANT FELIU SASSERRA,"BAGES, EL                ",24152,33983,58135
17162,SANT FERRIOL,"GARROTXA, LA             ",1421,4476,5897
08209,SANT FOST DE CAMPSENTELLES,"VALLÈS ORIENTAL, EL      ",391908,180489,572397
08213,SANT FRUITOS DE BAGES,"BAGES, EL                ",380988,295203,676191
17163,SANT GREGORI,"GIRONÈS, EL     ",129037,189250,318287
25192,SANT GUIM DE FREIXENET,"SEGARRA, LA              ",34581,164702,199283
25197,SANT GUIM DE LA PLANA,"SEGARRA, LA              ",7551,30381,37932
17164,SANT HILARI SACALM,"SELVA, LA                ",205274,586570,791844
08215,SANT HIPOLIT DE VOLTREGA,OSONA                    ,133417,29415,162832
08193,SANT ISCLE DE VALLALTA,"MARESME, EL              ",61427,11490,72917
08216,SANT JAUME DE FRONTANYA,"BERGUEDÀ, EL             ",1462,1469,2931
17165,SANT JAUME DE LLIERCA,"GARROTXA, LA             ",31189,70424,101613
43137,SANT JAUME DELS DOMENYS,"BAIX PENEDÈS, EL         ",130720,34267,164987
43902,SANT JAUME D'ENVEJA,"MONTSIÀ, EL              ",140304,33128,173432
17167,SANT JOAN DE LES ABADESSES,"RIPOLLÈS, EL             ",124835,377785,502620
17168,SANT JOAN DE MOLLET,"GIRONÈS, EL     ",20814,7727,28541
08218,SANT JOAN DE VILATORRADA,"BAGES, EL                ",400042,408492,808534
08217,SANT JOAN DESPI,"BAIX LLOBREGAT, EL       ",1244924,613717,1858641
17185,SANT JOAN LES FONTS,"GARROTXA, LA             ",137776,1071522,1209298
17166,SANT JORDI DESVALLS,"GIRONÈS, EL     ",33949,14783,48732
08903,SANT JULIA DE CERDANYOLA,"BERGUEDÀ, EL             ",10906,416,11322
17903,SANT JULIA DE LLOR I BONMATI,"SELVA, LA                ",54437,30527,84964
17169,SANT JULIA DE RAMIS,"GIRONÈS, EL     ",148193,27793,175986
08220,SANT JULIA DE VILATORTA,OSONA                    ,133879,62307,196186
08221,SANT JUST DESVERN,"BAIX LLOBREGAT, EL       ",884166,372264,1256430
17171,SANT LLORENÇ DE LA MUGA,"ALT EMPORDÀ, L'          ",11161,3555,14716
25193,SANT LLORENÇ DE MORUNYS,"SOLSONÈS, EL             ",58214,31385,89599
08222,SANT LLORENÇ D'HORTONS,"ALT PENEDÈS, L'          ",82513,131143,213656
08223,SANT LLORENÇ SAVALL,"VALLÈS OCCIDENTAL, EL    ",99590,30639,130229
08225,SANT MARTI D'ALBARS,"LLUÇANÈS, EL",4778,53097,57875
08224,SANT MARTI DE CENTELLES,OSONA                    ,50765,22643,73408
17172,SANT MARTI DE LLÈMENA,"GIRONÈS, EL     ",28532,6688,35220
25902,SANT MARTI DE RIUCORB,"URGELL, L'               ",26979,1136,28115
08226,SANT MARTI DE TOUS,"ANOIA, L'                ",44888,3301,48189
08227,SANT MARTI SARROCA,"ALT PENEDÈS, L'          ",137422,30200,167622
08228,SANT MARTI SESGUEIOLES,"ANOIA, L'                ",11810,9953,21763
17173,SANT MARTI VELL,"GIRONÈS, EL     ",10450,5997,16447
08229,SANT MATEU DE BAGES,"BAGES, EL                ",19732,59743,79475
17174,SANT MIQUEL DE CAMPMAJOR,"PLA DE L'ESTANY, EL      ",1763,13349,15112
17175,SANT MIQUEL DE FLUVIA,"ALT EMPORDÀ, L'          ",32913,7345,40258
17176,SANT MORI,"ALT EMPORDÀ, L'          ",12828,316,13144
17177,SANT PAU DE SEGURIES,"RIPOLLÈS, EL             ",30695,14565,45260
08231,SANT PERE DE RIBES,"GARRAF, EL               ",1356298,321731,1678029
08232,SANT PERE DE RIUDEBITLLES,"ALT PENEDÈS, L'          ",93271,63945,157216
08233,SANT PERE DE TORELLO,OSONA                    ,78894,88789,167683
08234,SANT PERE DE VILAMAJOR,"VALLÈS ORIENTAL, EL      ",216436,73962,290398
17178,SANT PERE PESCADOR,"ALT EMPORDÀ, L'          ",96033,275534,371567
08189,SANT PERE SALLAVINERA,"ANOIA, L'                ",7282,16114,23396
08235,SANT POL DE MAR,"MARESME, EL              ",343182,85877,429059
08236,SANT QUINTI DE MEDIONA,"ALT PENEDÈS, L'          ",84798,69084,153882
08237,SANT QUIRZE DE BESORA,OSONA                    ,80398,24868,105266
08238,SANT QUIRZE DEL VALLES,"VALLÈS OCCIDENTAL, EL    ",885550,399163,1284713
08239,SANT QUIRZE SAFAJA,Moianès,35889,26512,62401
25194,SANT RAMON,"SEGARRA, LA              ",18224,102167,120391
08240,SANT SADURNI D'ANOIA,"ALT PENEDÈS, L'          ",462761,424449,887210
08241,SANT SADURNI D'OSORMORT,OSONA                    ,0,4784,4784
08098,SANT SALVADOR DE GUARDIOLA,"BAGES, EL                ",156737,53364,210101
08262,SANT VICENÇ DE CASTELLET,"BAGES, EL                ",370700,313025,683725
08264,SANT VICENÇ DE MONTALT,"MARESME, EL              ",549674,252604,802278
08265,SANT VICENÇ DE TORELLO,OSONA                    ,73280,172515,245795
08263,SANT VICENÇ DELS HORTS,"BAIX LLOBREGAT, EL       ",1108326,621515,1729841
43138,SANTA BARBARA,"MONTSIÀ, EL              ",136215,63953,200168
08243,SANTA CECILIA DE VOLTREGA,OSONA                    ,6114,35868,41982
08244,SANTA COLOMA DE CERVELLO,"BAIX LLOBREGAT, EL       ",306545,142744,449289
17180,SANTA COLOMA DE FARNERS,"SELVA, LA                ",536064,146716,682780
08245,SANTA COLOMA DE GRAMENET,"BARCELONÈS, EL           ",4049550,1186092,5235642
43139,SANTA COLOMA DE QUERALT,"CONCA DE BARBERÀ, LA     ",84848,53712,138560
17181,SANTA CRISTINA D'ARO,"BAIX EMPORDÀ, EL         ",425376,822546,1247922
08246,SANTA EUGENIA DE BERGA,OSONA                    ,76455,646571,723026
08247,SANTA EULALIA DE RIUPRIMER,OSONA                    ,48960,26220,75180
08248,SANTA EULALIA DE RONÇANA,"VALLÈS ORIENTAL, EL      ",276970,83900,360870
08249,SANTA FE DEL PENEDES,"ALT PENEDÈS, L'          ",14057,2275,16332
17182,SANTA LLOGAIA D'ALGUEMA,"ALT EMPORDÀ, L'          ",14049,24150,38199
08250,SANTA MARGARIDA DE MONTBUI,"ANOIA, L'                ",339897,72311,412208
08251,SANTA MARGARIDA I ELS MONJOS,"ALT PENEDÈS, L'          ",280321,427712,708033
08253,SANTA MARIA DE BESORA,OSONA                    ,7729,16309,24038
08256,SANTA MARIA DE MARTORELLES,"VALLÈS ORIENTAL, EL      ",34535,5438,39973
08255,SANTA MARIA DE MERLES,"BERGUEDÀ, EL             ",5606,22343,27949
08257,SANTA MARIA DE MIRALLES,"ANOIA, L'                ",9215,1850,11065
08259,SANTA MARIA DE PALAUTORDERA,"VALLÈS ORIENTAL, EL      ",401009,174860,575869
08258,SANTA MARIA D'OLO,Moianès,33738,37241,70979
43140,SANTA OLIVA,"BAIX PENEDÈS, EL         ",171194,512377,683571
17184,SANTA PAU,"GARROTXA, LA             ",65392,104165,169557
08260,SANTA PERPETUA DE MOGODA,"VALLÈS OCCIDENTAL, EL    ",997275,1091903,2089178
08261,SANTA SUSANNA,"MARESME, EL              ",178217,476330,654547
08192,SANTPEDOR,"BAGES, EL                ",288643,219210,507853
43142,SARRAL,"CONCA DE BARBERÀ, LA     ",32842,172907,205749
17186,SARRIA DE TER,"GIRONÈS, EL     ",177209,1174849,1352058
25201,SARROCA DE BELLERA,"PALLARS JUSSÀ, EL        ",21384,1899,23283
25200,SARROCA DE LLEIDA,"SEGRIÀ, EL               ",14628,1102,15730
17187,"SAUS, CAMALLERA I LLAMPAIES","ALT EMPORDÀ, L'          ",55492,18558,74050
43143,SAVALLA DEL COMTAT,"CONCA DE BARBERÀ, LA     ",4261,0,4261
43144,"SECUITA, LA","TARRAGONÈS, EL           ",73936,3177,77113
17188,"SELVA DE MAR, LA","ALT EMPORDÀ, L'          ",16476,4101,20577
43145,"SELVA DEL CAMP, LA","BAIX CAMP, EL            ",175127,621201,796328
43146,SENAN,"CONCA DE BARBERÀ, LA     ",1741,109,1850
43044,"SENIA, LA","MONTSIÀ, EL              ",192984,15776,208760
25202,SENTERADA,"PALLARS JUSSÀ, EL        ",24156,6312,30468
25035,"SENTIU DE SIO, LA","NOGUERA, LA              ",31500,2152,33652
08267,SENTMENAT,"VALLÈS OCCIDENTAL, EL    ",351050,115526,466576
17190,SERINYA,"PLA DE L'ESTANY, EL      ",46142,43911,90053
25204,SEROS,"SEGRIÀ, EL               ",68805,55969,124774
17191,SERRA DE DARO,"BAIX EMPORDÀ, EL         ",19408,12350,31758
17192,SETCASES,"RIPOLLÈS, EL             ",35145,72186,107331
25203,"SEU D'URGELL, LA","ALT URGELL, L'           ",537243,647514,1184757
08269,SEVA,OSONA                    ,146806,251256,398062
25205,SIDAMON,"PLA D'URGELL, EL         ",29784,11880,41664
17193,SILS,"SELVA, LA                ",320882,215546,536428
08270,SITGES,"GARRAF, EL               ",2030798,935108,2965906
17052,SIURANA,"ALT EMPORDÀ, L'          ",6549,3034,9583
08271,SOBREMUNT,"LLUÇANÈS, EL",1724,972,2696
25206,"SOLERAS, EL","GARRIGUES, LES           ",9421,6667,16088
43147,SOLIVELLA,"CONCA DE BARBERÀ, LA     ",20845,8232,29077
25207,SOLSONA,"SOLSONÈS, EL             ",359547,95093,454640
08272,SORA,OSONA                    ,9105,27301,36406
25208,SORIGUERA,"PALLARS SOBIRÀ, EL       ",40400,2423,42823
25209,SORT,"PALLARS SOBIRÀ, EL       ",91446,47916,139362
25210,SOSES,"SEGRIÀ, EL               ",81114,138410,219524
08273,SUBIRATS,"ALT PENEDÈS, L'          ",119854,64385,184239
25211,SUDANELL,"SEGRIÀ, EL               ",30329,28024,58353
25212,SUNYER,"SEGRIÀ, EL               ",15265,9574,24839
08274,SURIA,"BAGES, EL                ",216847,1266925,1483772
17194,SUSQUEDA,"SELVA, LA                ",4380,1940,6320
08276,TAGAMANENT,"VALLÈS ORIENTAL, EL      ",8617,2304,10921
08277,TALAMANCA,"BAGES, EL                ",12172,2467,14639
25215,TALARN,"PALLARS JUSSÀ, EL        ",33437,60697,94134
25216,TALAVERA,"SEGARRA, LA              ",9223,32345,41568
17195,"TALLADA D'EMPORDA, LA","BAIX EMPORDÀ, EL         ",36533,27953,64486
08278,TARADELL,OSONA                    ,245345,163338,408683
43148,TARRAGONA,"TARRAGONÈS, EL           ",5680430,3090740,8771170
25217,TARREGA,"URGELL, L'               ",686333,466778,1153111
25218,TARRES,"GARRIGUES, LES           ",1273,13033,14306
25219,TARROJA DE SEGARRA,"SEGARRA, LA              ",5238,3142,8380
08275,TAVERNOLES,OSONA                    ,13578,16580,30158
08280,TAVERTET,OSONA                    ,10565,3765,14330
08281,TEIA,"MARESME, EL              ",355044,115915,470959
25220,TERMENS,"NOGUERA, LA              ",57225,136814,194039
17196,TERRADES,"ALT EMPORDÀ, L'          ",12333,1660,13993
08279,TERRASSA,"VALLÈS OCCIDENTAL, EL    ",8302227,3723191,12025418
08282,TIANA,"MARESME, EL              ",383120,96744,479864
25221,TIRVIA,"PALLARS SOBIRÀ, EL       ",13761,921,14682
25222,TIURANA,"NOGUERA, LA              ",2083,918,3001
43149,TIVENYS,"BAIX EBRE, EL            ",28131,8268,36399
43150,TIVISSA,"RIBERA D'EBRE, LA        ",74469,59669,134138
08283,TONA,OSONA                    ,300989,137924,438913
25223,TORA,"SEGARRA, LA              ",47026,49726,96752
08284,TORDERA,"MARESME, EL              ",799882,293238,1093120
08285,TORELLO,OSONA                    ,662245,299742,961987
25224,"TORMS, ELS","GARRIGUES, LES           ",4290,967,5257
25225,TORNABOUS,"URGELL, L'               ",62964,1610,64574
25227,"TORRE DE CAPDELLA, LA","PALLARS JUSSÀ, EL        ",75816,8732,84548
08286,"TORRE DE CLARAMUNT, LA","ANOIA, L'                ",218849,94183,313032
43151,"TORRE DE FONTAUBELLA, LA","PRIORAT, EL              ",4453,345,4798
43152,"TORRE DE L'ESPANYOL, LA","RIBERA D'EBRE, LA        ",23715,1736,25451
25226,TORREBESSES,"SEGRIÀ, EL               ",13756,9306,23062
43153,TORREDEMBARRA,"TARRAGONÈS, EL           ",952091,251811,1203902
25228,TORREFARRERA,"SEGRIÀ, EL               ",195608,154167,349775
25907,TORREFETA I FLOREJACS,"SEGARRA, LA              ",17395,130422,147817
25230,TORREGROSSA,"PLA D'URGELL, EL         ",62051,22822,84873
25231,TORRELAMEU,"NOGUERA, LA              ",31076,9714,40790
08287,TORRELAVIT,"ALT PENEDÈS, L'          ",39650,50382,90032
08288,TORRELLES DE FOIX,"ALT PENEDÈS, L'          ",124692,21132,145824
08289,TORRELLES DE LLOBREGAT,"BAIX LLOBREGAT, EL       ",265092,27677,292769
17197,TORRENT,"BAIX EMPORDÀ, EL         ",23615,29830,53445
25232,TORRES DE SEGRE,"SEGRIÀ, EL               ",99708,59081,158789
25233,TORRE-SERONA,"SEGRIÀ, EL               ",19498,18918,38416
17198,TORROELLA DE FLUVIA,"ALT EMPORDÀ, L'          ",41176,37992,79168
17199,TORROELLA DE MONTGRI,"BAIX EMPORDÀ, EL         ",777714,708872,1486586
43154,TORROJA DEL PRIORAT,"PRIORAT, EL              ",7031,288,7319
17200,TORTELLA,"GARROTXA, LA             ",32038,28602,60640
43155,TORTOSA,"BAIX EBRE, EL            ",1066049,3069316,4135365
17201,TOSES,"RIPOLLÈS, EL             ",18071,21724,39795
17202,TOSSA DE MAR,"SELVA, LA                ",437543,477958,915501
25234,TREMP,"PALLARS JUSSÀ, EL        ",242466,76702,319168
17204,ULLA,"BAIX EMPORDÀ, EL         ",52556,42400,94956
08290,ULLASTRELL,"VALLÈS OCCIDENTAL, EL    ",78470,24110,102580
17205,ULLASTRET,"BAIX EMPORDÀ, EL         ",21668,3326,24994
43156,ULLDECONA,"MONTSIÀ, EL              ",224270,226393,450663
43157,ULLDEMOLINS,"PRIORAT, EL              ",17277,5923,23200
17203,ULTRAMORT,"BAIX EMPORDÀ, EL         ",14322,13107,27429
17206,URUS,"CERDANYA, LA             ",39427,2231,41658
08291,VACARISSES,"VALLÈS OCCIDENTAL, EL    ",324849,131885,456734
17014,"VAJOL, LA","ALT EMPORDÀ, L'          ",3693,197,3890
17208,"VALL DE BIANYA, LA","GARROTXA, LA             ",48366,124564,172930
25043,"VALL DE BOI, LA","ALTA RIBAGORÇA, L'       ",259365,208969,468334
25901,VALL DE CARDOS,"PALLARS SOBIRÀ, EL       ",49005,13401,62406
17207,"VALL D'EN BAS, LA","GARROTXA, LA             ",119345,202216,321561
08292,VALLBONA D'ANOIA,"ANOIA, L'                ",60738,12709,73447
25238,VALLBONA DE LES MONGES,"URGELL, L'               ",10699,20342,31041
08293,VALLCEBRE,"BERGUEDÀ, EL             ",6546,1115,7661
43158,VALLCLARA,"CONCA DE BARBERÀ, LA     ",5881,3395,9276
25240,VALLFOGONA DE BALAGUER,"NOGUERA, LA              ",113321,74485,187806
17170,VALLFOGONA DE RIPOLLES,"RIPOLLÈS, EL             ",9702,10127,19829
43159,VALLFOGONA DE RIUCORB,"CONCA DE BARBERÀ, LA     ",4883,9710,14593
08294,VALLGORGUINA,"VALLÈS ORIENTAL, EL      ",138291,23567,161858
08295,VALLIRANA,"BAIX LLOBREGAT, EL       ",704380,134042,838422
17209,VALL-LLOBREGA,"BAIX EMPORDÀ, EL         ",55733,29562,85295
43160,VALLMOLL,"ALT CAMP, L'             ",66219,179608,245827
08296,VALLROMANES,"VALLÈS ORIENTAL, EL      ",173534,257481,431015
43161,VALLS,"ALT CAMP, L'             ",790724,586470,1377194
25906,"VALLS D'AGUILAR, LES","ALT URGELL, L'           ",8744,752,9496
25239,"VALLS DE VALIRA, LES","ALT URGELL, L'           ",42336,22800,65136
43162,VANDELLOS I L'HOSPITALET DE L'INFANT,"BAIX CAMP, EL            ",368704,163847,532551
25909,"VANSA I FORNOLS, LA","ALT URGELL, L'           ",23561,2527,26088
08297,VECIANA,"ANOIA, L'                ",3817,25292,29109
43163,"VENDRELL, EL","BAIX PENEDÈS, EL         ",2263141,566049,2829190
17210,VENTALLO,"ALT EMPORDÀ, L'          ",45858,26474,72332
25242,VERDU,"URGELL, L'               ",34776,37512,72288
17211,VERGES,"BAIX EMPORDÀ, EL         ",52358,20899,73257
43164,VESPELLA DE GAIÀ,"TARRAGONÈS, EL           ",37234,10062,47296
08298,VIC,OSONA                    ,1792222,1637861,3430083
17212,VIDRA,OSONA                    ,6627,3551,10178
17213,VIDRERES,"SELVA, LA                ",623014,268088,891102
25243,VIELHA E MIJARAN,"VAL D'ARAN, LA           ",619056,195952,815008
43165,VILABELLA,"ALT CAMP, L'             ",29858,17471,47329
17214,VILABERTRAN,"ALT EMPORDÀ, L'          ",32671,15312,47983
17215,VILABLAREIX,"GIRONÈS, EL     ",119884,42704,162588
08299,VILADA,"BERGUEDÀ, EL             ",15209,1836,17045
17217,VILADAMAT,"ALT EMPORDÀ, L'          ",19960,8923,28883
17216,VILADASENS,"GIRONÈS, EL     ",6986,3306,10292
08301,VILADECANS,"BAIX LLOBREGAT, EL       ",2376903,666663,3043566
08300,VILADECAVALLS,"VALLÈS OCCIDENTAL, EL    ",320713,198701,519414
17218,VILADEMULS,"PLA DE L'ESTANY, EL      ",47684,96864,144548
17220,VILADRAU,OSONA                    ,85111,362745,447856
17221,VILAFANT,"ALT EMPORDÀ, L'          ",215262,75035,290297
08305,VILAFRANCA DEL PENEDÈS,"ALT PENEDÈS, L'          ",1506878,460148,1967026
25244,VILAGRASSA,"URGELL, L'               ",21883,16888,38771
17223,VILAJUIGA,"ALT EMPORDÀ, L'          ",53084,20618,73702
43175,VILALBA DELS ARCS,TERRA ALTA               ,19809,8095,27904
08306,VILALBA SASSERRA,"VALLÈS ORIENTAL, EL      ",21964,4171,26135
25245,VILALLER,"ALTA RIBAGORÇA, L'       ",57996,6991,64987
17224,VILALLONGA DE TER,"RIPOLLÈS, EL             ",24580,12413,36993
43166,VILALLONGA DEL CAMP,"TARRAGONÈS, EL           ",84559,73760,158319
17225,VILAMACOLUM,"ALT EMPORDÀ, L'          ",13353,2909,16262
17226,VILAMALLA,"ALT EMPORDÀ, L'          ",46730,241058,287788
17227,VILAMANISCLE,"ALT EMPORDÀ, L'          ",11474,455,11929
25247,VILAMOS,"VAL D'ARAN, LA           ",23760,9770,33530
17228,VILANANT,"ALT EMPORDÀ, L'          ",16784,7932,24716
25248,VILANOVA DE BELLPUIG,"PLA D'URGELL, EL         ",72360,1296,73656
25254,VILANOVA DE LA BARCA,"SEGRIÀ, EL               ",37475,29335,66810
25249,VILANOVA DE L'AGUDA,"NOGUERA, LA              ",6840,34996,41836
25250,VILANOVA DE MEIA,"NOGUERA, LA              ",17479,65922,83401
43168,VILANOVA DE PRADES,"CONCA DE BARBERÀ, LA     ",3877,7358,11235
08303,VILANOVA DE SAU,OSONA                    ,10374,24029,34403
25251,VILANOVA DE SEGRIA,"SEGRIÀ, EL               ",40425,13792,54217
08302,VILANOVA DEL CAMI,"ANOIA, L'                ",443299,109898,553197
08902,VILANOVA DEL VALLES,"VALLÈS ORIENTAL, EL      ",247853,41932,289785
43167,VILANOVA D'ESCORNALBOU,"BAIX CAMP, EL            ",18823,9004,27827
08307,VILANOVA I LA GELTRÚ,"GARRAF, EL               ",2689160,980592,3669752
43169,VILAPLANA,"BAIX CAMP, EL            ",15853,1128,16981
43170,VILA-RODONA,"ALT CAMP, L'             ",67637,29454,97091
17230,VILA-SACRA,"ALT EMPORDÀ, L'          ",26514,5843,32357
25252,VILA-SANA,"PLA D'URGELL, EL         ",28505,17432,45937
43171,VILA-SECA,"TARRAGONÈS, EL           ",1231910,4729831,5961741
08214,VILASSAR DE DALT,"MARESME, EL              ",476417,221614,698031
08219,VILASSAR DE MAR,"MARESME, EL              ",916649,158363,1075012
17222,VILAÜR,"ALT EMPORDÀ, L'          ",7052,3451,10503
43172,VILAVERD,"CONCA DE BARBERÀ, LA     ",15741,16139,31880
43173,"VILELLA ALTA, LA","PRIORAT, EL              ",3164,1238,4402
43174,"VILELLA BAIXA, LA","PRIORAT, EL              ",8221,1032,9253
08304,VILOBI DEL PENEDES,"ALT PENEDÈS, L'          ",45426,50307,95733
17233,VILOBI D'ONYAR,"SELVA, LA                ",87959,145107,233066
17232,VILOPRIU,"BAIX EMPORDÀ, EL         ",22019,1693,23712
25253,"VILOSELL, EL","GARRIGUES, LES           ",12402.666666666666,5840,18242.666666666664
43176,VIMBODI I POBLET,"CONCA DE BARBERÀ, LA     ",31940,6611,38551
25255,VINAIXA,"GARRIGUES, LES           ",12746,6021,18767
43177,VINEBRE,"RIBERA D'EBRE, LA        ",18407,3550,21957
43178,VINYOLS I ELS ARCS,"BAIX CAMP, EL            ",98431,136388,234819
08308,VIVER I SERRATEIX,"BERGUEDÀ, EL             ",4684,77796,82480
43052,XERTA,"BAIX EBRE, EL            ",48839,13307,62146
,,,=SUM(D8:D955),=SUM(E8:E955),=SUM(F8:F955)
,,,,,
Origen dades: Elaboració ACA,,,,,
No inclou volums exempts,,,,,
Dades extretes de les declaracions presentades dels volums consumits facturats. Aquetes dades poden diferir dels consums efectuats durant l’any natural.,,,,,
